XXXXXXXXXXXXXXXXXXXXXXXX
XKKKKTX XBBBBBBX XCCCCCX
XKKKKKX  BBBBBB  XCCCCCX
XKKKKKX  BBBBBB  XCCCCTX
XKKKKKX XBBBBBBX XCXXXXX
XXXXX X X XXXX X       X
X                XXXXXXX
XXXXXXX           bbbbbX
XDDDDD   XXXXXX  XbbbbbX
XDDDDDX  XXXXXX  XXXXX X
XDDDDDX  XXXXXX        X
XDDDDDX  XXXXXX  XXX XXX
XDDDDDX  XXXXXX   LLLLLX
XXXXX X          XLLLLLX
X       XXX  XXX XXXXXXX
XXXXX X XHHHHHHX       X
XTllllX XHHHHHH  X XXXXX
XlllllX XHHHHHHX XSSSSTX
XlllllX XHHHHHHX XSSSSSX
XlllllX XHHHHHHX XSSSSSX
XXXXXXXXXXXXXXXXXXXXXXXX"